. N N N N N N N N .
N N N N N N N N N N
N N F N N N F N N N
N N N N N N N N N N
. N N N N N N N N .