G G G G G G G G G G
G N G N G N G N G G
G G G G G G G G G G
G N G F G F G N G G
G G G G G G G G G G