N G N G N G N G N G
G N G N G N G N G N
N N F N N N F N N N
G N G N G N G N G N
. G . G . G . G . .