G N N G N N G N N G
N G N N G N N G N N
N N G N N G N N G N
G N N G N N G N N G
N G N N G N N G F N
N N G N N G F N N G