N N N N N N N N N N
N N F N N N F N N N
N N N N N N N N N N
N N N G N G N N N N
N N N N N N N N N N