F N F N F N F N F N
N G N G N G N G N G
F N F N F N F N F N
N N G N F N G N N N
N F N N N N N F N N