N N N N N N N N N N
N G N N N N N N G N
N N N N N N N N N N
N N G N N N N G N N
N N N N N N N N N N