F N N N G N G N N F
N N N G N N N G N N
N N G N N N N N G N
N G N N N N N N N G
F N N N N N N N N F