F F F F F F F F F F
F G F G F G F G F G
G F G F G F G F G F
F G F G F G F G F G
F F F F F F F F F F

