G G G G G G G G G G
G N N N N N N N N G
G N G G G G G G N G
G N G N N N N G N G
G N G G G G G G N G
G N N N N N N N N G
G G G G G G G G G G