. . . . N N . . . .
. . . N N N N . . .
. . N N N N N N . .
. N N N N N N N N .
F F F F F F F F F F