G G G F G G G F G G
G G F G G G F G G G
G F G G G F G G G G
F G G G F G G G G G
G G G F G G G F G G
G G F G G F G G G G
G F G G F G G G G F