F N N N N N N N N F
N F N N N N N N F N
N N F N N N N F N N
N N N F N N F N N N
N N N N F F N N N N